1111111111111111111111111111
111P0000000C0000000000000111
1100000000000000000000C00011
1000000000000C00000000000001
10000C0000000000000000C00001
110000000000000C000000001011
1110000C0000000000000001E111
1111111111111111111111111111
