1111111111111111
1C0000C0000C0001
10111000C0011101
1001C11111000P01
10E01000C0000001
1111111111111111
