11111111111111111111111111111111111111111
1C0000C0000C000C0000C0000C000C0000C0000C1
10111000C0011100111000C0011100111000C0011
1001C11111000P0001C1111100000001C11111001
10E00000C0000000000000C0000000000000C0001
1C0000C0000C000C0000C0000C000C0000C0000C1
10111000C0011100111000C0011100111000C0011
1001C1111100000001C1111100000001C11111001
10000000C0000000000000C0000000000000C0001
11111111111111111111111111111111111111111